e66666666666666666666666666666666666666666666666666666666666666666666666666666666f
815545545545545545975545545545545545545545545559754554554554554554554554554554559a
870000000000000000970000000000000000000000000009700000000000000000000000000000009a
870000000000000000970000000000000000000000000009700000000000000000000000000000009a
870000000000000000970000000000000000000000000009700000000000000000000000000000009a
870000000000000000970000000000000000000000000009700000000000000000000000000000009a
870000002222200000970000000000000000000000000009700000000000000000000000000000009a
870000000000000000000000000000000000000000000000000000000000000000000000000000009a
870000000000000000000000333330003333300033333000000000000000000000000000000000009a
8122222222222222222d000091117000911170009111700c22222222222d000000000000000000009a
8111111111111111111700009111700091117000911170091111111111170000000000c2222222221a
811111111111111111170000000000000000000000000009111111111117000000000000000000009a
811111111111111111170000000000000000000000000009111111111117000000000000000000009a
811111111111111111170000000000000000000000000009111111111117000000000000000000009a
81111111111111111117000000000000000000000000000911111111111122222222d000000000009a
811111111111111111170000000000000000000000000009111111111117000000000000000000009a
811111111111111111170000000000000000000000000009111111111117000000000000000000009a
811111111111111111170000000000000000000000000009111111111117000000000000000000009a
8111111111111111111700003333300033333300000000091111111111170000000000c2222222221a
811111111111111111170000911170009111170000000009111111111117000000000000000000009a
811111111111111111170000000000000000000000000009111111111117000000000000000000009a
811111111111111111170000000000000000000000000009111111111117000000000000000000009a
81111111111111111117000000000000000000000c22222111111111111122222222d000000000009a
811111111111111111170000000000000000000000000009111111111117000000000000000000009a
811111111111111111170000000000000000000000000009111111111117000000000000000000009a
811111111111111111170000000000000000000000000000000000000000000000000000000000009a
8111111111111111111700003333300000000000000000000000000000000000000000c2222222221a
81111111111111111117000091117000000000000000000c222222222222222222222211111111111a
811111111111111111170000000000000000000000000009111111111111111111111111111111111a
8111111111111111111700000000000000000000000000c1111111111111111111111111111111111a
811111111111111111170000000000000000000000000000000000000000000000000000000000009a
811111111111111111170000000000000000000000000000000000000000000000000000000000009a
811111111111111111112222222222222222222222222222222222222222222222222222222222221a
811111111111111111111111111111111111111111111111111111111111111111111111111111111a
811111111111111111111111111111111111111111111111111111111111111111111111111111111a
811111111111111111111111111111111111111111111111111111111111111111111111111111111a
811111111111111111111111111111111111111111111111111111111111111111111111111111111a
811111111111111111111111111111111111111111111111111111111111111111111111111111111a
811111111111111111111111111111111111111111111111111111111111111111111111111111111a
