11111111111111111111111111111111111111111111111111111111111111111111111111111111
15545545545545545515545545545545545545545545551554554554554554554554554554554551
10000000000000000010000000000000000000000000001000000000000000000000000000000001
10000000000000000010000000000000000000000000001000000000000000000000000000000001
10000000000000000010000000000000000000000000001000000000000000000000000000000001
10000000000000000010000000000000000000000000001000000000000000000000000000000001
10000002222200000010000000000000000000000000001000000000000000000000000000000001
10000000000000000000000000000000000000000000000000000000000000000000000000000001
12000000000000000000000333330003333300033333000000000000000000000000000000000001
11222222222222222220000111110001111100011111002222222222222000000000000000000001
11111111111111111170000111110001111100011111009111111111111000000000002222222221
11111111111111111170000000000000000000000000009111111111111000000000000000000001
11111111111111111170000000000000000000000000009111111111111000000000000000000001
11111111111111111170000000000000000000000000009111111111111000000000000000000001
11111111111111111170000000000000000000000000009111111111111222222222000000000001
11111111111111111170000000000000000000000000009111111111111000000000000000000001
11111111111111111170000000000000000000000000009111111111111000000000000000000001
11111111111111111170000000000000000000000000009111111111111000000000000000000001
11111111111111111170000444440004444400000000009111111111111000000000022222222221
11111111111111111170000111110001111100000000009111111111111000000000000000000001
11111111111111111170000000000000000000000000009111111111111000000000000000000001
11111111111111111170000000000000000000000000009111111111111000000000000000000001
11111111111111111170000000000000000000002222221111111111111222222222000000000001
11111111111111111170000000000000000000000000009111111111111000000000000000000001
11111111111111111170000000000000000000000000009111111111111000000000000000000001
11111111111111111170000000000000000000000000000000000000000000000000000000000001
11111111111111111170000444440000000000000000000000000000000000000000022222222221
11111111111111111170000111110000000000000000002222222222222222222222211111111111
11111111111111111170000000000000000000000000001111111111111111111111111111111111
11111111111111111170000000000000000000000000011111111111111111111111111111111111
11111111111111111170000000000000000000000000000000000000000000000000000000000001
11111111111111111170000000000000000000000000000000000000000000000000000000000001
11111111111111111111111111111111111111111111111111111111111111111111111111111111
11111111111111111111111111111111111111111111111111111111111111111111111111111111
11111111111111111111111111111111111111111111111111111111111111111111111111111111
11111111111111111111111111111111111111111111111111111111111111111111111111111111
11111111111111111111111111111111111111111111111111111111111111111111111111111111
11111111111111111111111111111111111111111111111111111111111111111111111111111111
11111111111111111111111111111111111111111111111111111111111111111111111111111111
