lm6666666666666666666666666666666666666666666666666666666666666666666666666666666m
875545545545545545975545545545545545545545545559754554554554554554554554554554559a
870000000000000000970000000000000000000000000009700000000000000000000000000000009a
870000000000000000970000000000000000000000000009700000000000000000000000000000009a
870000000000000000970000000000000000000000000009700000000000000000000000000000009a
870000000000000000970000000000000000000000000009700000000000000000000000000000009a
870000002222200000no000000000000000000000000000no00000000000000000000000000000009a
870000000000000000000000000000000000000000000000000g000h0000000000000000000000009a
870000000000000000000000333330003333300033333000000000000000000000000000000000009a
81222222222222222222222222222222222222222222222222222222222d000000000000000000009a
81111111111111111117ppppppppppppppppppppppppppp11111111111170000000000c2222222221a
811111111111111111170000000000000000000000000009111111111117000000000000000000009a
811111111111111111170000000000000000000000000009111111111117000000000000000000009a
811111111111111111170000000000000000000000000009111111111117000000000000000000009a66666666666666666666666666666666666666666666666666666666666666666f
81111111111111111117000000000000000000000000000911111111111122222222d000000000009111111111111111111111111111111111111111111111111111111111111111119a
8111111111111111111700000000000000000000000000091111111111170000000000000000000091????????????????????????????????????????????????????????????????9a
811111111111111111170000000000000000000000000009111111111117000000000000h000000091????????????????????????????????????????????????????????????????9a
8111111111111111111700000000000000000000000000091111ppppppp7000000000000000i000091????????????????????????????????????????????????????????????????9a
8111111111111111111700003333300033333300000000091117q000000b0000000000c22222222211????????????????????????????????????????????????????????????????9a
81111111111111111117000091117000911117000000000911170000000b0000000000000000000091????????????????????????????????????????????????????????????????9a
81111111111111111117000000000000000000000000000911170000000000g0000000000000000091????????????????????????????????????????????????????????????????9a
8111111111111111111700000000000000000000000000091117i03330000000000000000000000091????????????????????????????????????????????????????????????????9a
81111111111111111117000000000000000000000c22222111112222222222222222d0000000000091????????????????????????????????????????????????????????????????9a
811111111111111111170000000000000000000000000009111111pppp170000000000000000000091????????????????????????????????????????????????????????????????9a
811111111111111111170000000000000000000000000009ppppp70000970000000000000000000091????????????????????????????????????????????????????????????????9a
8111111111111111111700000000000000000000000000000000000000000000000000000000000091????????????????????????????????????????????????????????????????9a
8111111111111111111700003333300000000000000000000000000000000000000000c22222222211????????????????????????????????????????????????????????????????9a
81111111111111111117000091117000000000000000000c22222222222222222222221ppp11111111????????????????????????????????????????????????????????????????9a
8111111111111111111700000000000000000000000000091111111111111111111111700091111111????????????????????????????????????????????????????????????????9a
811111111111111111170000000000000000000000000c2pppppppppppppppppppppppp000pppppppp????????????????????????????????????????????????????????????????9a
811111111111111111170000000000000000000000000000000000000000000000000000000b00000b????????????????????????????????????????????????????????????????9a
811111111111111111170000000000000000000000000000000000000000000000000000000b00000b????????????????????????????????????????????????????????????????9a
8111111111111111111n2222222222222222222222222222222222222222222222222222222222222222222222222222222222222222222222222222222222222222222222222222222a
811111111111111111111111111111111111111111111111111111111111111111111111111111111111111111111111111111111111111111111111111111111111111111111111111a
811111111111111111111111111111111111111111111111111111111111111111111111111111111111111111111111111111111111111111111111111111111111111111111111111a
811111111111111111111111111111111111111111111111111111111111111111111111111111111111111111111111111111111111111111111111111111111111111111111111111a
811111111111111111111111111111111111111111111111111111111111111111111111111111111111111111111111111111111111111111111111111111111111111111111111111a
811111111111111111111111111111111111111111111111111111111111111111111111111111111111111111111111111111111111111111111111111111111111111111111111111a
811111111111111111111111111111111111111111111111111111111111111111111111111111111111111111111111111111111111111111111111111111111111111111111111111a
