e66666666666666666666666666666666666666666666666666666666666666666666666666666666f
875545545545545545975545545545545545545545545559754554554554554554554554554554559a
870000000000000000970000000000000000000000000009700000000000000000000000000000009a
870000000000000000970000000000000000000000000009700000000000000000000000000000009a
870000000000000000970000000000000000000000000009700000000000000000000000000000009a
870000000000000000970000000000000000000000000009700000000000000000000000000000009a
870000002222200000970000000000000000000000000009700000000000000000000000000000009a
870000000000000000000000000000000000000000000000000g000h0000000000000000000000009a
8700000000000000000000003333300033333000333330000000000000000000000000000000i0009a
81222222222222222222222222222222222222222222222222222222222d000000000000000000009a
8111111111111111111711111111111111111111111111111111111111170000000000c2222222221a
811111111111111111170000000000000000000000000009111111111117000000000000000000009a
8111111111111111111700000000000000000000000000091111111111170i0000000000000000009a
811111111111111111170000000000000000000000000009111111111117000000000000000000009a66666666666666666666666666666666666666666666666666666666666666666f
81111111111111111117000000000000000000000000000911111111111122222222d000000000009111111111111111111111111111111111111111111111111111111111111111119a
8111111111111111111700000000000000000000000000091111111111170000000000000000000091????????????????????????????????????????????????????????????????9a
811111111111111111170000000000000000000000000009111111111117000000000000h000000091????????????????????????????????????????????????????????????????9a
8111111111111111111700000000000000000000000000091111111111170000000000000000000091????????????????????????????????????????????????????????????????9a
8111111111111111111700003333300033333300000000091111111111170000000000c22222222211????????????????????????????????????????????????????????????????9a
8111111111111111111700009111700091111700000000091111111111170000000000000000000091????????????????????????????????????????????????????????????????9a
81111111111111111117000000000000000000000000000911111111111700g0000000000000000091????????????????????????????????????????????????????????????????9a
8111111111111111111700000000000000000000000000091111111111170000000000000000000091????????????????????????????????????????????????????????????????9a
81111111111111111117000000000000000000000c22222111111111111122222222d0000000000091????????????????????????????????????????????????????????????????9a
8111111111111111111700000000000000000000000000091111111111170000000000000000000091????????????????????????????????????????????????????????????????9a
8111111111111111111700000000000000000000000000091111111111170000000000000000000091????????????????????????????????????????????????????????????????9a
81111111111111111117000000000000000000000000000000000000000000000000i0000000000091????????????????????????????????????????????????????????????????9a
8111111111111111111700003333300000000000000000000000000000000000000000c22222222211????????????????????????????????????????????????????????????????9a
811111111111111111170000911170000000000000000i0c2222222222222222222222111111111111????????????????????????????????????????????????????????????????9a
8111111111111111111700000000000000000000000000091111111111111111111111111111111111????????????????????????????????????????????????????????????????9a
811111111111111111170000000000000000000000000c211111111111111111111111111111111111????????????????????????????????????????????????????????????????9a
811111111111111111170000000000000000000000000000000000000000000000000000000b00000b????????????????????????????????????????????????????????????????9a
811111111111111111170000000000000000000000000000000000000000000000000000000b00000b????????????????????????????????????????????????????????????????9a
811111111111111111112222222222222222222222222222222222222222222222222222222222222222222222222222222222222222222222222222222222222222222222222222222a
811111111111111111111111111111111111111111111111111111111111111111111111111111111a
811111111111111111111111111111111111111111111111111111111111111111111111111111111a
811111111111111111111111111111111111111111111111111111111111111111111111111111111a
811111111111111111111111111111111111111111111111111111111111111111111111111111111a
811111111111111111111111111111111111111111111111111111111111111111111111111111111a
811111111111111111111111111111111111111111111111111111111111111111111111111111111a
