e66666666666666666666666666666666666666666666666666666666666666666666666666666666f
8????????????????????????????????????????????????????????????????????????????????a
8????????????????????????????????????????????????????????????????????????????????a
8????????????????????????????????????????????????????????????????????????????????a
8????????????????????????????????????????????????????????????????????????????????a
8????????????????????????????????????????????????????????????????????????????????a
8????????????????????????????????????????????????????????????????????????????????a
8????????????????????????????????????????????????????????????????????????????????a
8????????????????????????????????????????????????????????????????????????????????a
8????????????????????????????????????????????????????????????????????????????????a
8????????????????????????????????????????????????????????????????????????????????a
8????????????????????????????????????????????????????????????????????????????????a
8????????????????????????????????????????????????????????????????????????????????a
8????????????????????????????????????????????????????????????????????????????????a66666666666666666666666666666666666666666666666666666666666666666f
8????????????????????????????????????????????????????????????????????????????????111111111111111111111111111111111111111111111111111111111111111119a
8????????????????????????????????????????????????????????????????????????????????155455455455455455455455455455455455455455455455455455455455455459a
8????????????????????????????????????????????????????????????????????????????????100000000000000000000000000000000000000000000000000000000000000009a
8????????????????????????????????????????????????????????????????????????????????100000000000000000000000000000000000000000000000000000000000000009a
8????????????????????????????????????????????????????????????????????????????????100000000000000000000000000000000000000000000000000000000000000009a
8????????????????????????????????????????????????????????????????????????????????100000000000000000000000000000000000000000000000000000000000000009a
8????????????????????????????????????????????????????????????????????????????????100000000000000000000000000000000000000000000000000000000000000009a
8????????????????????????????????????????????????????????????????????????????????100000000000000000000000000000000000000000000000000000000000000009a
8????????????????????????????????????????????????????????????????????????????????100000000000000000000000000000000000000000000000000000000000000009a
8????????????????????????????????????????????????????????????????????????????????100000000000000000000000000000000000000000000000000000000000000009a
8????????????????????????????????????????????????????????????????????????????????100000000000000000000000000000000000000000000000000000000000000009a
8????????????????????????????????????????????????????????????????????????????????100000000000000000000000000000000000000000000000000000000000000009a
8????????????????????????????????????????????????????????????????????????????????100000000000000000000000000000000000000000000000000000000000000009a
8????????????????????????????????????????????????????????????????????????????????100000000000000000000000000000000000000000000000000000000000000009a
8????????????????????????????????????????????????????????????????????????????????100000000000000000000000000000000000000000000000000000000000000009a
8????????????????????????????????????????????????????????????????????????????????100000000000000000000000000000000000000000000000000000000000000009a
8???????????????????????????????????????????????????????????????????????b00000000000000000000000000000000000000000000000000000000000000000000000009a
8???????????????????????????????????????????????????????????????????????b00000000000000000000000000000000000000000000000000000000000000000000000009a
8????????????????????????????????????????????????????????????????????????????????a22222222222222222222222222222222222222222222222222222222222222222a
8????????????????????????????????????????????????????????????????????????????????a
8????????????????????????????????????????????????????????????????????????????????a
8????????????????????????????????????????????????????????????????????????????????a
8????????????????????????????????????????????????????????????????????????????????a
8????????????????????????????????????????????????????????????????????????????????a
811111111111111111111111111111111111111111111111111111111111111111111111111111111a
