lm6666666666666666666666666666666666666666666666666666666666666666666666666666666m
8????????????????????????????????????????????????????????????????????????????????a
8????????????????????????????????????????????????????????????????????????????????a
8????????????????????????????????????????????????????????????????????????????????a
8????????????????????????????????????????????????????????????????????????????????a
8????????????????????????????????????????????????????????????????????????????????a
8????????????????????????????????????????????????????????????????????????????????a
8????????????????????????????????????????????????????????????????????????????????a
8????????????????????????????????????????????????????????????????????????????????a
8????????????????????????????????????????????????????????????????????????????????a
8????????????????????????????????????????????????????????????????????????????????a
8????????????????????????????????????????????????????????????????????????????????a
8????????????????????????????????????????????????????????????????????????????????a
8????????????????????????????????????????????????????????????????????????????????a66666666666666666666666666666666666666666666666666666666666666666m
8????????????????????????????????????????????????????????????????????????????????111111111111111111111111111111111111111111111111111111111111111119a
8????????????????????????????????????????????????????????????????????????????????155455455455455455455455455455455455455455455455455455455455455459a
8????????????????????????????????????????????????????????????????????????????????100000000000000000000000000000000000000000000000000000000000000009a
8????????????????????????????????????????????????????????????????????????????????100000000000000000000000000000000000000000000000000000000000000009a
8????????????????????????????????????????????????????????????????????????????????100000000000000000000000000000000000000000000000000000000000000009a
8????????????????????????????????????????????????????????????????????????????????100000000000000c222222222222222222222222222d0000000000000000000009a
8????????????????????????????????????????????????????????????????????????????????100000000000000000000000000000000000000000000000000000000000000009a
8????????????????????????????????????????????????????????????????????????????????100000000000000000000000000000000000000000000000000000000000000009a
8????????????????????????????????????????????????????????????????????????????????100000000000000000000000000000000000000000000000cd0000000000000009a
8????????????????????????????????????????????????????????????????????????????????100000000000000000000000000000000000000000000000000000000000000009a
8????????????????????????????????????????????????????????????????????????????????100000000000000000000000000000000000000000000000000000000cd0000009a
8????????????????????????????????????????????????????????????????????????????????100000000000000000000000000000000000000000000000000000000000000009a
8????????????????????????????????????????????????????????????????????????????????100000000000000000000000000000000000000000000000cd0000000000000009a
8????????????????????????????????????????????????????????????????????????????????100000000000000000000000000000000000000000000000000000000000000009a
8????????????????????????????????????????????????????????????????????????????????100000000000000000000000000000000000000000000000000000cd0000000009a
8???????????????????????????????????????????????????????????????????????554554554100000000000000000000000000000000000000000000000000000000000000009a
8???????????????????????????????????????????????????????????????????????b00000000000000000000000000000000000000000000000000000000000000000000000009a
8???????????????????????????????????????????????????????????????????????b00s00000000000000000000000000000000000000000000000000000000000000000000009a
8???????????????????????????????????????????????????????????????????????222222222222222222222222222222222222222222222222222222222222222222222222222a
8????????????????????????????????????????????????????????????????????????????????111111111111111111111111111111111111111111111111111111111111111111a
8????????????????????????????????????????????????????????????????????????????????111111111111111111111111111111111111111111111111111111111111111111a
8????????????????????????????????????????????????????????????????????????????????111111111111111111111111111111111111111111111111111111111111111111a
8????????????????????????????????????????????????????????????????????????????????111111111111111111111111111111111111111111111111111111111111111111a
8????????????????????????????????????????????????????????????????????????????????111111111111111111111111111111111111111111111111111111111111111111a
811111111111111111111111111111111111111111111111111111111111111111111111111111111111111111111111111111111111111111111111111111111111111111111111111a
811111111111111111111111111111111111111111111111111111111111111111111111111111111111111111111111111111111111111111111111111111111111111111111111111a
811111111111111111111111111111111111111111111111111111111111111111111111111111111111111111111111111111111111111111111111111111111111111111111111111a
81111111111111111111111111111111111111111111111111111111111111111111111111000k011111111111111111111111111111111111111111111111111111111111111111111a
811111111111111111111111111111111111111111111111111111111111111111111111110000011111111111111111111111111111111111111111111111111111111111111111111a
811111111111111111111111111111111111111111111111111111111111111111111111112222211111111111111111111111111111111111111111111111111111111111111111111a
811111111111111111111111111111111111111111111111111111111111111111111111111111111111111111111111111111111111111111111111111111111111111111111111111a
811111111111111111111111111111111111111111111111111111111111111111111111111111111111111111111111111111111111111111111111111111111111111111111111111a
811111111111111111111111111111111111111111111111111111111111111111111111111111111111111111111111111111111111111111111111111111111111111111111111111a
811111111111111111111111111111111111111111111111111111111111111111111111111111111111111111111111111111111111111111111111111111111111111111111111111a
811111111111111111111111111111111111111111111111111111111111111111111111111111111111111111111111111111111111111111111111111111111111111111111111111a
811111111111111111111111111111111111111111111111111111111111111111111111111111111111111111111111111111111111111111111111111111111111111111111111111a
811111111111111111111111111111111111111111111111111111111111111111111111111111111111111111111111111111111111111111111111111111111111111111111111111a
811111111111111111111111111111111111111111111111111111111111111111111111111111111111111111111111111111111111111111111111111111111111111111111111111a
811111111111111111111111111111111111111111111111111111111111111111111111111111111111111111111111111111111111111111111111111111111111111111111111111a
811111111111111111111111111111111111111111111111111111111111111111111111111111111111111111111111111111111111111111111111111111111111111111111111111a
