lm6666666666666666666666666666666666666666666666666666666666666666666666666666666m
875545545545545545975545545545545545545545545559754554554554554554554554554554559a
870000000000000000970000000000000000000000000009700000000000000000000000000000009a
870000000000000000970000000000000000000000000009700000000000000000000000000000009a
870000000000000000970000000000000000000000000009700000000000000000000000000000009a
870000000000000000970000000000000000000000000009700000000000000000000000000000009a
870000002222200000no000000000000000000000000000no00000000000000000000000000000009a
870000000000000000000000000000000000000000000000000000000000000000000000000000009a
870000000000000000000000333330003333300033333000000000000000000000000000000000009a
81222222222222222222222222222222222222222222222222222222222d000000000000000000009a
81111111111111111117ppppppppppppppppppppppppppp91111111111170000000000c2222222221a
811111111111111111170000000000000000000000000009111111111117000000000000000000009a
811111111111111111170000000000000000000000000009111111111117000000000000000000009a
811111111111111111170000000000000000000000000009111111111117000000000000000000009a66666666666666666666666666666666666666666666666666666666666666666f
81111111111111111117000000000000000000000000000911111111111122222222d000000000009111111111111111111111111111111111111111111111111111111111111111119a
8111111111111111111700000000000000000000000000091111111111170000000000000000000091????????????????????????????????????????????????????????????????9a
811111111111111111170000000000000000000000000009111111111117000000000000h000i00091????????????????????????????????????????????????????????????????9a
8111111111111111111700000000000000000000000000091111ppppppp70000000000000000000091????????????????????????????????????????????????????????????????9a
81111111111111111117000033333000333333000000000911170000000b0000000000c22222222211????????????????????????????????????????????????????????????????9a
81111111111111111117000091117000911117000000000911170000000b0000000000000000000091????????????????????????????????????????????????????????????????9a
8111111111111111111700000000000000000000000000091117i000000000g0000000000000000091????????????????????????????????????????????????????????????????9a
8111111111111111111700000000000000000000000000091117003330000000000000000000000091????????????????????????????????????????????????????????????????9a
81111111111111111117000000000000000000000c22222111112222222222222222d0000000000091????????????????????????????????????????????????????????????????9a
811111111111111111170000000000000000000000000009111111pppp170000000000000000000091????????????????????????????????????????????????????????????????9a
811111111111111111170000000000000000000000000009ppppp70000970000000000000000000091????????????????????????????????????????????????????????????????9a
8111111111111111111700000000000000000000000000000000000000000000000000000000000091????????????????????????????????????????????????????????????????9a
8111111111111111111700003333300000000000000000000000000000000000000000c22222222211????????????????????????????????????????????????????????????????9a
81111111111111111117000091117000000000000000000c22222222222222222222221ppp111111111????????????????????????????????????????????????????????????????9a
8111111111111111111700000000000000000000000000091111111111111111111117000911111111????????????????????????????????????????????????????????????????9a
81111111111111111117000000000000000000000000c2ppppppppppppppppppppppppp000pppppppp????????????????????????????????????????????????????????????????9a
811111111000000000000000000000000000000000000000000000000000000000000000000b00000b????????????????????????????????????????????????????????????????9a
811111111000000000000000000000000000000000000000000000000000000000000000000b00000b????????????????????????????????????????????????????????????????9a
81111111100000000000c222222222222222222222222222222222222222222222222222222222222222222222222222222222222222222222222222222222222222222222222222221a
811111111000000000000000000970000000000000000000000000000000000000000000091111111111111111111111111111111111111111111111111111111111111111111111111a
811111111000000000000000000970000000000000000000000000000000000000000000091111111111111111111111111111111111111111111111111111111111111111111111111a
8111111110000000000000000009700000000c222222222222222222222222222222d000091111111111111111111111111111111111111111111111111111111111111111111111111a
81111111100000cd0000000000091d000000097000000000000000000000000000000000091111111111111111111111111111111111111111111111111111111111111111111111111a
811111111000000000000000000970000000097000000000000000000000000000000000091111111111111111111111111111111111111111111111111111111111111111111111111a
811111111000000000cd0000000970000000c17000000c22222222222222222222222222221111111111111111111111111111111111111111111111111111111111111111111111111a
811111111000000000000000000970000000097000000000000000000000000000000000000000009111111111111111111111111111111111111111111111111111111111111111111a
8111111110000cd000000000000n1d000000c11d00000000000000000000000000000000000000009111111111111111111111111111111111111111111111111111111111111111111a
81111111100000000000000g00000000000009700000000h00000000g00000000000000000000k009111111111111111111111111111111111111111111111111111111111111111111a
811111111000000000000000000000000000097000000000000000000000000000000000000030009111111111111111111111111111111111111111111111111111111111111111111a
811111111222222222222222222222222222222222222222222222222222222222222222222222221111111111111111111111111111111111111111111111111111111111111111111a
811111111111111111111111111111111111111111111111111111111111111111111111111111111111111111111111111111111111111111111111111111111111111111111111111a
811111111111111111111111111111111111111111111111111111111111111111111111111111111111111111111111111111111111111111111111111111111111111111111111111a
811111111111111111111111111111111111111111111111111111111111111111111111111111111111111111111111111111111111111111111111111111111111111111111111111a
811111111111111111111111111111111111111111111111111111111111111111111111111111111111111111111111111111111111111111111111111111111111111111111111111a
811111111111111111111111111111111111111111111111111111111111111111111111111111111111111111111111111111111111111111111111111111111111111111111111111a
811111111111111111111111111111111111111111111111111111111111111111111111111111111111111111111111111111111111111111111111111111111111111111111111111a
811111111111111111111111111111111111111111111111111111111111111111111111111111111111111111111111111111111111111111111111111111111111111111111111111a
811111111111111111111111111111111111111111111111111111111111111111111111111111111111111111111111111111111111111111111111111111111111111111111111111a
811111111111111111111111111111111111111111111111111111111111111111111111111111111111111111111111111111111111111111111111111111111111111111111111111a
