lm6666666666666666666666666666666666666666666666666666666666666666666666666666666m
8????????????????????????????????????????????????????????????????????????????????a
8????????????????????????????????????????????????????????????????????????????????a
8????????????????????????????????????????????????????????????????????????????????a
8????????????????????????????????????????????????????????????????????????????????a
8????????????????????????????????????????????????????????????????????????????????a
8????????????????????????????????????????????????????????????????????????????????a
8????????????????????????????????????????????????????????????????????????????????a
8????????????????????????????????????????????????????????????????????????????????a
8????????????????????????????????????????????????????????????????????????????????a
8????????????????????????????????????????????????????????????????????????????????a
8????????????????????????????????????????????????????????????????????????????????a
8????????????????????????????????????????????????????????????????????????????????a
8????????????????????????????????????????????????????????????????????????????????a666666666666666666666666666666m
8????????????????????????????????????????????????????????????????????????????????1111111111111111111111111111119a
8????????????????????????????????????????????????????????????????????????????????1554554554554554554554554554559a
8????????????????????????????????????????????????????????????????????????????????7000000000000000000000000000009a
8????????????????????????????????????????????????????????????????????????????????7000000000000000000000000000009a
8????????????????????????????????????????????????????????????????????????????????7000000000000000000000000000009a
8????????????????????????????????????????????????????????????????????????????????7000000000000000000000000000009a
8????????????????????????????????????????????????????????????????????????????????7000000000000000000000000000009a
8????????????????????????????????????????????????????????????????????????????????70000000000000c222222d000000009a
8????????????????????????????????????????????????????????????????????????????????7000000000000000000000000000009a
8????????????????????????????????????????????????????????????????????????????????7000000000cd0000000000000000009a
8????????????????????????????????????????????????????????????????????????????????700000000000000000000000000cd09a
8????????????????????????????????????????????????????????????????????????????????7000000000000000000000000000009a
8????????????????????????????????????????????????????????????????????????????????700000cd000000000000cd000000009a
8????????????????????????????????????????????????????????????????????????????????7000000000000000000000000000009a
8????????????????????????????????????????????????????????????????????????????????7000000000000000000000000000009a
8???????????????????????????????????????????????????????????????????????55455455470cd0000000000000000000000cd009a
8???????????????????????????????????????????????????????????????????????b000000000000000000000000000000000000009a
8???????????????????????????????????????????????????????????????????????b000000000000000000000000000000000000009a
8???????????????????????????????????????????????????????????????????????2222222222222222222222222222222222222222a
8????????????????????????????????????????????????????????????????????????????????1111111111111111111111111111111a
8????????????????????????????????????????????????????????????????????????????????1111111111111111111111111111111a
8????????????????????????????????????????????????????????????????????????????????1111111111111111111111111111111a
8????????????????????????????????????????????????????????????????????????????????1111111111111111111111111111111a
8111111111111111111111111111111111111111111111111111111111111111111111111111111111111111111111111111111111111111a
8111111111111111111111111111111111111111111111111111111111111111111111111111111111111111111111111111111111111111a
8111111111111111111111111111111111111111111111111111111111111111111111111111111111111111111111111111111111111111a
81111111111111111111111111111111111111111111111111111111111111111111111111r00k0111111111111111111111111111111111a
8111111111111111111111111111111111111111111111111111111111111111111111111100000111111111111111111111111111111111a
8111111111111111111111111111111111111111111111111111111111111111111111111122222111111111111111111111111111111111a
8111111111111111111111111111111111111111111111111111111111111111111111111111111111111111111111111111111111111111a
8111111111111111111111111111111111111111111111111111111111111111111111111111111111111111111111111111111111111111a
8111111111111111111111111111111111111111111111111111111111111111111111111111111111111111111111111111111111111111a
8111111111111111111111111111111111111111111111111111111111111111111111111111111111111111111111111111111111111111a
8111111111111111111111111111111111111111111111111111111111111111111111111111111111111111111111111111111111111111a
8111111111111111111111111111111111111111111111111111111111111111111111111111111111111111111111111111111111111111a
8111111111111111111111111111111111111111111111111111111111111111111111111111111111111111111111111111111111111111a
8111111111111111111111111111111111111111111111111111111111111111111111111111111111111111111111111111111111111111a
